@Archipelago:
XXXXXXXXXXXXXXXXXXXXXXXXXXXXXXXXXXXXXXXX
XXXXXXXXXXXXXXXXXXXXXXXXXXXXXXXXXXXXXXXX
XXXXXXXXXXXXXXXXXXXXXXXXXXXXXXXXXXXXXXXX
XXXXXXXXXXXXXXXXXXXXXXXXXXXXXXXXXXXXXXXX
XXXXXXXXXXXXXXXXXXXXXXXXXXXXXXXXXXXXXXXX
XXXXXXXXXXXXXXXXXXEFXXXXXXXXXXXXXXXXXXXX
XXXXXXXXXXXXXXXXX#####XXXXXXXXXXXXXXXXXX
XXXXXXEFXXXXXXXXXXXXXXXXXXXXXXXFXXXXXXXX
XXXX#######XXXXXXXXXXXXXXXXX#######XXXXX
XXXXXXXXXXXXXXXXXXXXXXXXXXXXXXXXXXXXXXXX
XXXXXXXXXXXXXXXXXXXXXXXXXXXXXXXXXXXXXXXX
XXXXXXXXXXXXXEXXXXXXXXXXXEXXXXXXXXXXXXXX
XXXXXXXXXXXXX#############XXXXXXXXXXXXXX
XXXXXXXXXXXXXXXXXXXXXXXXXXXXXXXXXXXXXXXX
XXXXXXXXXXXXXXXXXXXXXXXXXXXXXXXXXXXXXXXX
XXXXXXXXXXFXXXXXXXXKXXXXXXXEFXXXXXXXXXXX
XXXXXXXX######XXXXXXXXXXX######XXXXXXXXX
XXXXXXXXXXXXXXXXXXXXXXXXXXXXXXXXXXXXXXXX
XXXXXXXXXXXXXXXXXXXXXXXXXXXXXXXXXXXXXXXX
XXXXXXXXXXXXXXXXXXXXXXXXXXXXXXXXXXXXXXXX
XXXXXXXXXXXXXXXX#######XXXXXXXXXXXXXXXXX
XXXXXXXXXXXXXXXXXXXXXXXXXXXXXXXXXXXXXXXX
XXXXXXXXXXXXXXXXXXXXXXXXXXXXXXXXXXXXXXXX
@Out of the Frying Pan...:
XXXXXXXXXXXXXXXXXXXXXXXXXXXXXXXXXXXXXXXX
XXXXXXXXXXXXXXXXXXXXXXXXXXXXXXXXXXXXXXXX
XXXXXXXXXXXXXXXXXXXXXXXXXXXXXXXXXXXXXXXX
XXXXXXXXXXXXXXXXXXXXXXXXXXXXXXXXXXXXXXXX
XXXXXXXXXXFXXEXXXXXXXXXXXEXXFXXXXXXXXXXX
XXXXXXXX######XXXXXXXXXXX######XXXXXXXXX
XXXXXXXXXXXXXXXXXXXXXXXXXXXXXXXXXXXXXXXX
XXXXXXXEXFXXXXXXXXXXXXXXXXXXXFXEXXXXXXXX
XXXXX#############XXX#############XXXXXX
XXXXXXXXXXXXXXXXXXXXXXXXXXXXXXXXXXXXXXXX
XXXXXXXXXXXXXXXXXXXXXXXXXXXXXXXXXXXXXXXX
XXXXXXXXXXXXXXXXXXXFXXEXXXXXXXXXXXXXXXXX
XXXXXXXXXXXXXX###########XXXXXXXXXXXXXXX
XXXXXXXXXXXXXXXXXXXXXXXXXXXXXXXXXXXXXXXX
XXXXXXXXXXXXXXXXXXXXXXXXXXXXXXXXXXXXXXXX
XXXXXXXXXXXFXXEXXXXKXXXXEXXFXXXXXXXXXXXX
XXXXXXXXX######XXXXXXXXX######XXXXXXXXXX
XXXXXXXXXXXXXXXXXXXXXXXXXXXXXXXXXXXXXXXX
XXXXXXXXXXXXXXXXXXXXXXXXXXXXXXXXXXXXXXXX
XXXXXXXXXXXEXXXXXXXXXXXXXXXXXXXXXEXXXXXX
XXXX###############################XXXXX
XXXXXXXXXXXXXXXXXXXXXXXXXXXXXXXXXXXXXXXX
XXXXXXXXXXXXXXXXXXXXXXXXXXXXXXXXXXXXXXXX
@Xavier's Cave:
XXXXXXXXXXXXXXXXXXXXXXXXXXXXXXXXXXXXXXXX
XXXXXXXXXXXXXXXXXXXXXXXXXXXXXXXXXXXXXXXX
XXXXXXXXXXXXXXXXXXXXXXXXXXXXXXXXXXXXXXXX
XXXXXXXXXXXXXXXXXXXXXXXXXXXXXXXXXXXXXXXX
XXXXXXXXXXXXXXX#XXXXXXXXXXXXXXXXXXXXXXXX
XXXXXXXEFXXXXXXXXXXXX#XXXXXXXXXXXXXXXXXX
XXXXX######XXXXXXXXXXXXXXXXXXXXXXXXXXXXX
XXXXXXXXXXXXXXXXX#XXXXXXXXXEXFXXEXXXXXXX
XXXXXXXXXXXXX#XXXXXXXXXXX##########XXXXX
XXXXXXXXXXXXXXXXXXXXXXXXXXXXXXXXXXXXXXXX
XXXXXXXXXXXXXXXXXXXXX#XXXXXXXXXXXXXXXXXX
XXXXXXXFXXXXXXX#XXXXXXXXXXXXXXXXXXXXXXXX
XXXXXX###XXXXXXXXXXXXXXXEFXXXXXXXXXXXXXX
XXXXXXXXXXXX#XXXXXXXXXX#####XXXXXXXXXXXX
XXXXXXXXXXXXXXXXXXX#XXXXXXXXXXXXXXXXXXXX
XXXXXXXXXXXXXXXXXXXXXXXXXXXXXXXXXXXXXXXX
XXXXXXXXXXXXXXXXXXXXXXXXXKXXXXEXFXXXXXXX
XXXXXXFXXEXXXXXX#XXXXXXXXXXXX#######XXXX
XXX#######XXXXXXXXXXXXXXXXXXXXXXXXXXXXXX
XXXXXXXXXXXXXXXXXXXX#XXXXFXXXXXXXXXXXXXX
XXXXXXXXXXXXXXXXXXXXXXXX###XXXXXXXXXXXXX
XXXXXXXXXXXXXXXXXXXXXXXXXXXXXXXXXXXXXXXX
XXXXXXXXXXXXXXXXXXXXXXXXXXXXXXXXXXXXXXXX
